WWWWWWWWWWWWWWWWWWWWW
WGGGGGGGGGGGGGGGGGGWW
WGGGGGGGGGGGGGGGGGGWW
WGGGGGGGGGGGGWGGGGGWW
WGGGGGGGGGGGEWGGGGGWW
WGGGGGGGGGGGGWGGGGTWW
WGGGGGGGGGGGGWGGGGGWW
WGGGGGGGGGGGGGGGGGWWW
WGGGGGGGGGGGGGGGGGGGG
WGGGGGGGGGGGGGGGGGGWW
WGGGGGGGGGGGGGGWGGNWW
WGGGGGGGGGFGGGGGGGEWW
WGGGGGGGGGGGGGGGGGGWW
WGGGGGGGGGGGGGGGGGJWW
WGGGGGGGGGGRWGGGGGGWW
WGGGGGGGGGGGGGGGGGGWW
WGGGGGGGGGGGGGGGGGGWW
WGGGGGGGGGGGGGGGWEGWW
WGGGGGGGGGGGGGGGGGGWW
WGGGGGGGGGGGGGGGGGNWW
WGGGGGGGGGGGGGGGGGGWW
WGGGGGGGGGGGGGGGGGGWW
WGGGGGGGGGGGGGGGGGGWW
WGGGGGGGGGGGGGGGGGEWW
WGGGGGGGGGGGGRGGGGEWW
WGGGGGGGGGGGGGGGGGEWW
WGGGGGGGGGGGGGGGGGEWW
WGGGGGGGGGGGGGGGWWEWW
WGGGGGGGGGGGGGGGGGGGG
WGGGGGGGGGGGGGGGGGGGG
WGGGGGGGGGGGGGGGGGGWW
WGGGGGGGGGGGGWGGGGGWW
WGGGGGGGGGGGEWGGGGGWW
WGGGGGGNGGGGGWGGGGTWW
WGGGGFGGGGGGGGGGGGGWW
WGGGGGGGGGGGGGGGGGWWW
WGGGGGGGGGGGGGGGGGGGG
WGGGGGGGGGGGGGWGGGGWW
WGGGGGGGGGGGGGGWGGNWW
WGGGGGGGGGFGGGGGGGEWW
WGGGGGGGGGGGGGGGGGGWW
WGGGGGGGGGGGGGGGGGJWW
WGGGGGGGGGGRWGGGGGGWW
WGGGGGGGGGGGGGGGGGGWW
WGGGGGGGGGGGGGGGGGGWW
WGGGGGGGGGGGGGGGWEGWW
WGGGGGGGGGGGGGGGGGGWW
WGGGGGGGGGGGGGGGGGNWW
WGGGGGGGGGGGGGGGGGGWW
WGGGGGGGGGGGGGGGGGGWW
PPPPPPPPPPPPPPPPPPPPP




